  	R	 1920 1080  
 F 220,  100,0
        C 225,255,0

NO ./path_to_the_north_texture1.xmp
SO ./path_to_the_south_texture2.xmp
WE ./path_to_the_west_texture3.xmp
EA ./path_to_the_east_texture4.xmp
S ./path_to_the_sprite_texture5.xmp


        1111111111111111111111111111
        11111111111 11111111111101
        10000000001 1000000000000111
        10110000011 111110000000000111
        1001000001  1 1 100000000001
        1001000001   11 100000000001
        1001000001111111100000000011111
        11111111111111111111111111111011
        1111111111111111111111111111111
11111111110000011100000000000011111
10N0000000110000011101111111111111111
11110111111111011100000010001
11110111111111011101010010001
11000000110101011100000010001
10002000000000001100000010001
10000000000000001101010010001
110000011111011111111110001111
111111111 111011 101111010001
111111111 1111111111111111111