
  	  F     230, 55, 110

C	225,0, 03

        111111111111 1111111111111
        10000000      0011 0000000000001
        1011000001  1  11 0000002000001
        100100000      011 000000000001
111111111011000001   000000000001
100000000011000001 1101111111111111111
111101111111110111 00000010001
111101111111110111 01010010001
110000001101010111 00000010001
100020000000000011 00000010001
10000000000000001101010010001
11000001110101011111011110N0111
11110111 1110101 101111010001
11111111 1111111 111111111111